NO textures/colorstone.png
SO textures/greystone.png
WE textures/bluestone.png
EA textures/purplestone.png

F 0,0,0
C 225,30,0

1111
1011
11111111111111111111111111111111111111111111111111111111111111111111111111111
1E000000000000000000000000000000000000000000000000000000000000000000000000111
11111111111111111111111111111111111111111111111111111111111111111111111111111
1011
1111
