NO textures/colorstone.png
SO textures/greystone.png
WE textures/bluestone.png
EA textures/purplestone.png

F 0,0,0
C 225,30,0

1111
1001
1N01
1001
1111
