1111111111111111111
1000000000000000001
1001000000011111001
1001110000000001001
1000000000000001001
1111111111111111111
