NO textures/stone.xpm
SO textures/stone.xpm
WE textures/brick.xpm
EA textures/wood.xpm

F 220,100,0
C 225,30,0

111111 
100101  
101001
1100N1  1
111111
