SO textures/greystone.png
WE textures/bluestone.png
EA textures/purplestone.ng
C 225,111,9119
F 220,100,0

 11111111111111111111111111111111111111
1000000000000000000000000000000000000001
1000000000000000000000000000000000000001
1000000000000000000000000000000000000001
1000000000000000000000000000000000000001
1000000000000000001010000000000000000001
1000000000000000001010000000000000000001
1000000000000000001N10010000000000000001
10000000S0000000001110010000000000000001
1000000000000000000000000000000000000001
1000000000000000000000000000000000000001
1000000000000000000000000000000000000001
1000000000000000000000000000000000000001
1000000020000000000000000000000000000001
 11111111111111111111111111111111111111
